█████████
█      ◈█
█ ███ ███
█   █   █
███ ███ █
█ █ █   █
█ ███ █ █
█S    █ █
█████████